2
0 6 0 5 0 4
6 10 0 5 0 4
10
64 288 256 288 3 1 1 0
256 288 256 224 3 1 1 90
256 224 192 224 3 1 1 0
192 224 128 224 3 1 1 0
128 224 64 224 3 1 1 0
64 224 64 288 3 1 1 90
128 96 192 96 3 1 1 0
192 96 192 224 3 1 1 90
192 224 128 224 3 1 1 0
128 224 128 96 3 1 1 90

288 48 30 0 0
